1
XXXXXXXXXXXXXXXXXXXXXXXXXXXXXXXXXXXXXXXXXXXXXXXXXXXXXXXXXXXXXXXXXXXXXXXXXXXXXXXXXXXXXXXXXXXXXXXXXXXXX
X.X...X.X.....X.........X.....X.....X...X...X.........X.....X...........X.X.........X.....X...X...X.X
X.X.X.X.XXX.X.XXXXX.XXX.X.XXX.X.XXX.X.XXX.X.X.XXXXX.XXX.X.XXX.XXXXXXX.X.X.X.XXXXXXX.X.X.XXX.X.X.X.X.X
X.X.X.....X.X.......X...X.X.X...X.X.X.X...X.X.X...X.X...X.........X...X.X.......X.X.X.X.....X...X...X
X.X.XXXXX.X.XXXXXXXXXXX.X.X.XXXXX.X.X.X.XXX.X.XXX.X.X.XXXXXXXXXXXXX.XXX.X.XXXXX.X.X.X.XXXXXXXXXXXXX.X
X...X...X.X.X.......X.X.X.X.X.....X.X...X...X...X.X...X...X.......X.X.X.X.....X.X...X.X.....X.......X
XXXXX.X.X.X.X.XXXXX.X.X.X.X.X.X.XXX.XXXXX.XXXXX.X.XXXXX.X.X.XXXXX.X.X.X.XXXXX.X.X.XXXXX.XXX.XXX.X.XXX
X.....X.X...X.....X.X...X.X...X...X...X.......X.......X.X.X.X...X...X.X.X.....X.X.X.X...X.......X...X
XXX.X.X.XXXXXXX.XXX.X.XXX.X.XXX.XXXXX.X.XXXXX.XXXXXXX.X.XXX.X.XXXXXXX.X.X.XXXXX.X.X.X.XXXXXXXXXXXXX.X
X...X.X.X.......X...X.....X.X...X.....X.....X.....X...X...X.X...X.......X.X.....X.....X...X.....X...X
XXXXX.X.XXXXX.XXX.XXXXXXXXXXX.XXX.XXXXXXXXX.XXXXX.X.XXXXX.X.X.X.X.X.XXXXXXX.XXXXX.XXXXX.X.XXX.X.X.XXX
X.....X.X...X.X...X...........X...X.........X...X.X.....X.X.X.X...X.......X...X...X.....X...X.X.X...X
X.XXXXX.X.X.XXX.o.X.XXXXXXXXXXX.XXX.X.XXXXXXX.X.X.XXXXX.X.X.XXXXXXXXXXXXX.XXX.XXXXX.XXXXXXX.X.X.XXX.X
X.....X.X.X...X.X.....X.......X.X...X.........X.X...X...X.X...........X.......X...X...X.....X.X.....X
XXXXX.X.X.XXX.X.XXXXXXX.XXX.X.X.X.XXXXXXXXX.XXX.XXX.X.XXX.XXXXXXXXXXX.XXXXXXXXX.X.XXX.X.XXXXX.XXXXXXX
X.....X...X.X.X.X.......X...X.X.X.X...X...X.X.X...X...X.........X...X...........X...X.X.X...X.X.....X
X.XXXXXXXXX.X.X.X.XXXXXXX.XXXXX.X.X.X.X.X.XXX.XXX.XXXXXXX.X.XXX.X.X.XXXXXXXXXXXXX.X.X.X.X.XXX.X.XXX.X
X.....X.......X.X...X...X.X...X.X.X.X...X...X...........X.X.X.....X.X.......X...X.X.X.X.X.....X.X...X
XXXXX.X.XXXXXXX.X.XXX.X.X.X.X.X.X.X.XXXXXXX.XXXXXXXXXXX.XXX.XXXXXXX.X.XXXXX.X.X.X.XXX.X.XXXXX.X.XXX.X
X.....X.....X.....X...X.X...X.X.X.X.X.....X.......X...X...X.......X.X.X...X.X.X.X.....X.....X...X.X.X
X.XXXXXXXXX.XXXXXXX.XXX.XXXXX.X.XXX.X.XXX.XXXXXXX.X.XXXXX.XXXXXXX.X.X.X.X.X.X.X.XXXXXXXXXXX.XXXXX.X.X
X.....X...X.X...X...X.X.......X.....X...X.......X.X.X.....X.......X.X...X.X...X.......X...X...X.X...X
XXXXX.X.X.X.X.X.X.XXX.XXXXX.XXXXXXXXXXX.X.XXXXXXX.X.X.XXXXX.XXXXXXX.XXXXX.XXX.XXXXXXX.XXX.XXX.X.X.XXX
X.....X.X.X...X.X...X...X...X.........X.X.........X.X.X.....X.X.....X...X...X.X.....X.....X...X...X.X
X.XXXXXXX.XXXXX.X.X.XXX.X.XXX.XXXXXXX.X.XXXXXXXXXXX.X.XXX.XXX.X.XXXXX.X.XXX.X.X.XXX.XXXXX.X.XXX.XXX.X
X.......X.....X.X.X...X.....X...XXX.X.X.X.......X...X.....X.....X.....X.....X.X...X...X...X.X...X...X
X.XXXXX.XXXXX.X.X.XXX.XXXXX.XXX.XXX.X.X.X.XXXXX.XXX.X.XXXXX.XXXXXXXXX.XXXXXXXXXXX.XXX.XXXXX.X.XXX.X.X
X...X.X.X...X...X...X...X.X.X.X.X...X...X.X...X...X...X...X.......X...X...X...X...X.X.....X.X...X.X.X
XXX.X.X.X.X.X.XXXXXXXXX.X.X.X.X.XXX.XXXXX.X.X.XXX.XXXXX.X.XXXXXXX.XXX.X.X.X.X.X.XXX.XXXXX.X.XXX.XXX.X
X...X.X...X.X...X...X...X...X.X.........X...X.X.........X.....X.......X.X...X...X.....X...X...X...X.X
X.XXX.XXXXX.XXX.X.X.X.XXX.XXX.XXXXXXXXX.XXXXX.XXXXXXXXXXXXXXX.X.XXXXX.X.XXXXXXXXXXX.X.X.XXXXX.XXX.X.X
X.....X.X...X.X...X...X.X.X...X.......X.....X.......X.......X.X.X...X.X...........X.X.X...X...X.....X
XXXXX.X.X.XXX.XXXXXXXXX.X.X.X.XXX.XXX.XXXXX.XXXXXXX.XXXXXXX.X.XXX.X.XXXXX.XXXXXXX.X.X.XXX.X.XXXXXXX.X
X.......X.X.........X...X.X.X.....X.....X.X.........X...X...X.X...X.X.....X.X.....X.X.X.X.X.....X...X
X.XXXXXXX.XXX.XXX.XXX.XXX.X.XXXXXXXXXXX.X.XXXXXXXXXXX.X.X.X.X.X.XXX.X.XXXXX.X.XXXXX.XXX.X.XXXXX.XXX.X
X...X...X...X...X.......X.X.X.......X.....X.........X.X...X.X...X.X.X.X.....X.X.X.....X...X...X...X.X
X.XXX.X.X.X.X.XXXXX.XXX.X.X.X.XXXXX.X.XXX.X.XXX.XXXXX.XXXXX.XXXXX.X.X.XXX.XXX.X.X.XXX.X.XXX.X.XXX.X.X
X.X...X.X.X.X.X...X.X...X.X.......X.X.X...X...X...........X.......X.X.....X...X.....X.X.....X.....X.X
X.X.XXX.X.X.XXX.X.XXX.XXX.XXXXXXXXX.X.XXXXXXX.XXXXXXXXXXX.XXXXXXXXX.XXXXX.X.XXXXXXXXX.XXXXXXXXXXXXX.X
X.X...X.X.X...X.X.....X.............X.X.....X...X.....X...X.........X...X.X.X...X.....X.......X.....X
X.XXX.X.XXXXX.X.X.XXXXX.XXXXXXXXXXXXXXX.XXX.XXX.XXX.X.X.XXX.XXXXXXXXX.X.XXX.X.X.X.XXX.X.XXX.XXX.XXXXX
X...X.X.......X.X.X.....X.X...X.....X...X.X.X...X...X.X.....X.........X.X...X.X...X...X.X...X...X...X
XXX.X.XXXXXXXXX.XXX.XXXXX.X.X.X.XXX.X.XXX.X.X.XXX.X.XXXXXXXXX.XXXXXXX.X.X.XXX.XXXXX.XXXXX.XXX.XXXXX.X
X.X.X.X.......X...X.X...X.X.X...X.X.X.....X...X...X...X.........X.....X.X.X...X...X.X.....X...X.....X
X.X.X.X.XXXXX.X.X.X.X.X.X.X.XXXXX.X.XXXXX.XXXXX.XXXXX.X.XXXXXXX.X.XXXXX.X.X.X.X.X.X.XXX.XXX.XXX.X.X.X
X.X.X...X.....X.X...X.X...X.X.....X...X...X.........X.......X...X.X.......X.X.X.X.X.....X...X...X.X.X
X.X.XXXXX.X.XXXXXXX.X.XXXXX.X.XXX.XXX.X.XXXXXXXXXXX.XXXXXXXXXXX.X.XXXXXXXXXXX.XXX.XXXXX.X.XXX.XXX.XXX
X...X...X.X.X.....X...X...X...X.X...X.X...........X.....X.....X.X.........X...X.......X.X.X.X...X...X
X.XXX.X.X.X.X.XXX.XXXXX.X.XXXXX.X.XXX.XXXXXXXXXXX.XXX.XXX.XXX.XXXXXXXXXXX.X.X.X.XXX.X.X.X.X.XXX.X.XXX
X...X.X.X.X.X...X.......X.......X.X.....X...X.X...X.X.X...X.X...X.....X...X.X.X.X...X.X.X.X...X.X...X
XXX.XXX.X.XXXXX.XXXXXXXXXXX.X.XXX.X.XXX.X.X.X.X.XXX.X.X.XXX.XXX.X.XXX.X.XXX.X.XXX.XXXXX.X.XXX.X.XXX.X
X.X.....X.....X.X...X.....X.X.X...X.X.....X...X.X...X.X.X.....X.X...X...X...X...X.......X...X...X.X.X
X.XXX.XXXXX.XXX.X.X.XXXXX.X.X.X.XXX.XXXXXXX.XXX.X.X.X.X.XXX.XXX.X.X.XXXXX.XXXXX.X.XXXXXXXXX.X.XXX.X.X
X...X...X...X.X...X.....X.X.X.X...X.X.........X.X.X...X.X.X...X.X.X...X.....X...X.X...X.X...X.....X.X
X.XXXXX.X.X.X.XXXXXXXXX.X.X.XXXXX.X.XXXXX.XXXXX.XXXXXXX.X.X.X.X.XXXXX.XXXXX.X.XXX.X.X.X.X.XXXXXXXXX.X
X.......X.X...........X.X.X.......X.X...X...X...X.....X.X...X.X.....X...X.X.X.X.....X...X.........X.X
XXXXXXXXX.X.XXXXXXX.XXX.X.XXXXXXXXX.X.X.XXXXX.XXX.XXX.X.XXXXX.XXXXX.XXX.X.X.X.XXXXXXXXX.XXXXXXXXX.X.X
X.........X.X.....X.X...X...X...X...X.X.......X...X...X...X.X.....X.....X...X.....X.X.......X...X...X
X.XXX.XXXXXXX.XXX.XXX.XXX.X.X.X.X.X.X.XXXXXXXXXXX.X.XXXXX.X.X.XXX.XXXXXXXXXXXXXXX.X.X.XXXXXXX.X.XXX.X
X.X...X.....X.X...X...X...X...X.X.X.X...X.....X...X.....X.X...X...X.....X...X.....X...X.....X.X.....X
X.XXXXX.XXX.X.X.X.X.XXX.XXXXXXXXX.X.XXX.XXX.X.X.X.XXXXX.X.X.XXX.X.X.XXXXX.X.X.XXXXXXXXX.XXX.X.XXXXXXX
X.X.....X.X...X.X.X.X.........X...X.X...X...X.X.X.X...X...X.X...X...X.X...X.X...X...X...X.X.X.....X.X
X.X.XXXXX.XXXXX.XXX.X.XXXXXXX.X.XXXXX.XXX.XXX.X.XXX.X.XXXXXXX.XXXXX.X.X.X.X.XXX.X.X.X.XXX.X.XXXXX.X.X
X.X...X...X...X.....X.....X...X...X...X...X...X...X.X.X.....X.X...X...X.X.X...X...X.X.X.X.X...X...X.X
X.XXX.X.X.X.X.XXXXXXXXXXXXX.X.XXX.X.XXXXX.X.XXXXX.X.X.X.XXX.X.X.X.XXXXX.X.XXX.XXXXX.X.X.X.X.XXX.XXX.X
X.X...X.X...X...X...X.......X.X.X...X.....X.....X...X...X...X...X.......X.X.........X.X...X...X.X...X
X.X.XXXXXXXXX.X.X.X.X.XXXXXXX.X.XXXXX.X.XXXXXXX.X.XXXXXXX.XXX.XXXXXXX.XXX.XXXXXXXXXXX.X.X.XXX.X.X.X.X
X...X.........X.X.X.X.......X.X.....X.X.......X.X.......X...X.X.X...X...X.........X...X.X...X...X.X.X
X.XXX.X.XXXXXXX.X.X.X.XXXXX.X.X.XXX.XXXXXXXXX.X.XXXXXXXXXXX.X.X.X.X.XXXXXXX.XXXXX.X.XXXXXXX.XXXXXXX.X
X.X...X...X.......X.X...X...X.X...X...X.......X.............X...X.X.......X.X.....X.X...........X...X
X.X.XXXXX.XXXXXXXXX.XXX.X.XXX.XXX.XXX.X.X.XXXXXXXXXXXXXXX.XXXXXXX.XXXXXXX.X.X.XXX.X.X.XXXXXXXXX.X.X.X
X.X...X.X...X.....X.X...X...X...X...X...X...X.X.....X.....X.............X.X.X...X.X...X.....X.X.X.X.X
X.XXX.X.XXX.X.XXX.X.XXX.XXX.XXX.X.X.XXXXXXX.X.X.XXX.XXXXXXX.XXXXXXXXXXX.X.XXXXX.XXXXXXX.XXXXX.X.X.XXX
X...X.....X...X...X...X...X...X.X.X.X.....X...X.X...X.....X.X.......X.X.X.....X.........X.......X...X
XXX.XXXXXXXXXXX.XXXXX.XXX.XXX.X.XXX.X.XXX.XXXXX.X.XXX.XXX.X.X.XXXXX.X.X.XXXXX.X.XXX.XXXXX.XXXXXXXXX.X
X.X...........X...X...X.X.X...X...X...X...X.....X.......X...X.X...X.X.X...X...X...X.......X.......X.X
X.XXXXXXXXXXX.XXX.X.XXX.X.X.XXXXX.X.XXX.XXX.XXXXXXXXXXXXXXXXX.X.XXX.X.XXX.X.X.XXXXXXXXXXX.X.XXXXX.X.X
X...X.....X...X...X.X.X...X...X...X...X...X.X.....X...X.....X.X.....X.....X.X.X.........X...X.......X
X.X.XXXXX.X.XXX.XXX.X.X.XXXXX.X.XXXXXXXXX.X.X.XXX.X.X.XXX.XXX.X.XXXXX.XXXXX.XXX.XXXXXXX.XXXXXXXXXXX.X
X.X.X...X.X...X.X...X...X.....X.....X.....X.X.X.X...X...X.X...X.....X.....X...........X.X.....X...X.X
X.X.X.X.X.XXX.X.X.XXXXXXX.XXXXXXXXX.X.X.XXX.X.X.X.XXXXX.X.X.XXXXXXX.XXX.XXXXXXXXXXXXX.X.X.XXX.XXX.X.X
X.X...X.....X...X.X.......X.....X...X.X.X...X...X...X.....X.....X.X...X.X.....X.......X...X.X...X.X.X
X.XXXXXXXXX.XXXXX.XXX.XXXXXXX.X.X.XXX.XXX.XXX.XXXXX.X.XXXXXXXXX.X.XXX.XXX.XXX.XXXXXXXXXXX.X.XXX.X.X.X
X.X...X...X.X...X.X...X.....X.X...X...X...X...X.....X.X.X.......X...X.....X.X.X.........X...X...X...X
X.XXX.X.X.X.X.XXX.X.XXX.XXX.XXX.XXX.XXX.XXXXXXX.XXXXX.X.X.XXXXXXXXX.XXXXXXX.X.X.XXXXXXX.XXXXX.XXX.XXX
X...X...X.X.X...X.X...X.X.X.X.X...X.....X.......X.X.....X.X.........X.....X...X...X...........X...X.X
XXX.X.XXX.X.XXX.X.X.X.X.X.X.X.XXX.X.XXXXX.XXXXXXX.X.XXXXX.XXXXXXX.X.X.X.X.X.XXXXX.XXXXXXXXXXXXX.XXX.X
X...X.X.X.X.....X.X.X.....X.X...X.X.......X.......X.X.....X.......X.X.X.X.X.X.....X...X.......X.....X
X.XXX.X.X.X.XXXXX.XXXXXXXXX.X.XXX.XXXXXXXXX.X.XXXXX.X.XXXXX.XXXXXXXXX.X.X.X.XXX.XXX.X.X.XXXXX.XXXXX.X
X.X.X...X...X...X.........X.X.X...X...X...X.X.X.....X.....X...........X.X.X...X.X...X...X...X.X.X...X
X.X.XXX.XXXXX.X.XXXXXXXXX.X.X.X.XXX.X.X.XXX.X.X.XXXXX.XXX.XXX.XXXXXXXXX.X.XXX.X.X.XXXXXXXXX.X.X.X.XXX
X.X...X...X...X.....X...X.X.X...X...X.X.X...X...X...X.X...X...X...X...X.X.X...X...X...X.....X.X...X.X
X.XXX.X.XXX.XXXXXXX.X.X.X.X.XXX.X.XXX.X.X.XXXXX.X.X.XXX.XXX.XXX.X.X.XXX.XXX.XXX.X.X.X.XXX.XXX.X.XXX.X
X...X...X...X...X...X.X...X...X...X.X.X...X...X.X.X.....X.X.X...X.X.X...X...X.X.X...X.....X...X.X...X
X.X.XXXXX.XXXXX.X.XXX.XXXXX.X.XXXXX.X.X.XXX.X.X.X.XXXXXXX.X.X.XXX.X.X.X.X.XXX.X.XXXXXXXXXXX.XXX.X.X.X
X.X.....X...X...X...X.....X.X.X.....X.X.X...X.X.X...X.....X...X.X.X.X.X.X.X.....X...........X.X.X.X.X
X.XXXXX.XXX.X.X.XXX.XXXXX.X.X.XXXXX.X.XXX.XXX.XXXXX.XXX.X.XXXXX.X.X.X.XXX.XXXXXXX.XXXXXXXXXXX.X.XXX.X
X.....X...X...X...X.X.....X.X.X.....X.....X...X...X.X...X.....X.X.X.X.X.....X.....X.....X...X...X...X
XXXXX.XXX.XXXXX.XXX.X.XXXXXXX.X.XXXXXXXXXXX.XXX.X.X.X.XXX.XXXXX.X.X.X.X.XXX.X.X.XXX.X.X.X.X.X.XXX.XXX
X.......X.........X...........X.................X...X...X...........X...X.....X.X...X.X...X.........X
XXXXXXXXXXXXXXXXXXXXXXXXXXXXXXXXXXXXXXXXXXXXXXXXXXXXXXXXXXXXXXXXXXXXXXXXXXXXXXXXXXXXXXXXXXXXXXXXXXXXX
2
XXXXXXXXXXXXXXXXXXXXXXXXXXXXXXXXXXXXXXXXXXXXXXXXXXXXXXXXXXXXXXXXXXXXXXXXXXXXXXXXXXXXXXXXXXXXXXXXXXXXX
X.X.........X.........X.......X...X...X.....X.............X...X.......X.....X.................X.....X
X.X.X.XXXXX.XXX.XXXXXXX.X.XXXXX.X.X.X.X.XXX.X.XXXXXXXXX.X.X.XXX.X.XXXXX.XXX.X.X.XXXXXXXXXXXXX.X.XXX.X
X...X.....X...X.X.......X.......X...X...X.X.....X.....X.X.X...X.X.....X...X...X.....X.....X...X.X...X
XXXXX.XXX.XXX.X.X.XXXXXXXXXXXXXXXXXXXXXXX.XXXXXXX.XXX.X.X.XXX.X.XXXXX.XXX.XXXXXXXXX.X.XXX.X.XXX.X.XXX
X...X...X...X...X.X...X.X...............X.X.......X.X.X.X...X.X.....X.....X.......X...X...X...X.X...X
X.X.XXX.XXX.XXXXX.XXX.X.X.XXXXXXXXX.XXX.X.X.XXXXXXX.X.X.XXX.X.XXX.XXXXXXXXXXXXX.X.XXXXX.XXXXX.X.XXX.X
X.X.X.....X.X...X.X...............X.X.X.X.X.X.......X.X...X.X.....X...........X.X.....X...X...X...X.X
X.X.XXXXXXX.X.X.X.X.XXXXXXXXXXXXX.X.X.X.X.X.X.XXXXX.X.XXX.X.XXX.XXXXXXX.XXXXX.X.X.XXX.XXX.XXXXX.XXX.X
X.X.....X...X.X...X...X.......X.X.X.X...X.X.X...X...X...X.X.X.X.......X.X.....X.X.X.X...X.X...X.X...X
X.XXXXX.X.X.X.XXXXXXXXX.XXXXX.X.X.X.XXX.X.X.XXXXX.X.XXX.XXX.X.XXXXXXX.X.X.XXXXX.X.X.XXX.X.X.X.X.X.XXX
X...X.X.X.X.X.X.........X.....X...X...X.X.X.X.....X...X.X...X.......X.X.X.X.....X.X.....X...X...X...X
X.X.X.X.X.X.X.XXo.XXXXXXX.XXXXX.XXXXX.X.X.X.X.XXXXXXXXX.X.XXX.XXXXX.X.X.X.XXXXXXX.XXXXXXXXXXXXXXXXX.X
X.X.X.....X.X.X...X.....X.X...X.....X.X.X.X.X.X...X.....X.X...X...X.X...X.........X...X.............X
XXX.X.XXXXXXX.X.XXX.XXX.X.XXX.XXX.XXX.X.X.X.X.X.X.X.XXXXX.X.XXX.X.X.XXXXXXXXX.XXXXX.X.X.X.XXXXXXXXXXX
X...X.X.......X...X.X.X.X.X...X...X...X...X.X...X.........X...X.X.......X...X.X...X.X.X.X.X...X.....X
X.XXX.X.XXXXXXX.X.X.X.X.X.X.XXX.XXX.XXXXX.X.XXXXXXXXXXXXXXX.X.X.XXXXXXX.X.X.X.X.X.X.X.X.XXX.X.X.XXX.X
X...X.X...X.....X.X...X...X.....X.X.X.X...X...........X...X.X.X...X.......X.X.X.X...X...X...X...X.X.X
X.X.X.XXX.X.XXX.X.XXX.XXXXXXX.XXX.X.X.X.XXXXXXXXXXXXX.X.X.XXX.XXXXXXXXXXXXXXX.X.X.XXXXXXX.XXXXXXX.X.X
X.X.X...X.X.X.X.X...X.X.....X.....X.X...X.......X.....X.X.....X...X.........X.X.X.X...............X.X
X.X.XXX.X.X.X.XXXXX.X.X.X.X.XXX.XXX.X.XXX.XXXXX.X.XXXXX.XXXXX.X.X.X.XXXXXXX.X.X.X.X.XXXXX.XXXXXXXXX.X
X.X...X.X.X...X.....X.X.X.X...X.X...X...X...X...X...X...X.....X.X...X...X.X...X.X.X.....X.X...X.....X
X.XXX.XXX.XXX.X.XXXXX.XXX.XXX.XXX.XXXXX.XXX.X.XXXXX.XXX.XXXXX.X.XXXXX.X.X.XXXXX.XXXXXXX.XXX.X.X.XXXXX
X.X.X...X.X...X...X.X.....X.X.X...X...X...X.X...X...X...X...X.X.......X...X...X.....X.X.X...X...X...X
X.X.XXX.X.XXXXXXX.X.XXXXXXX.X.X.XXX.X.XXX.XXXXX.X.XXX.XXX.X.XXXXXXXXXXXXX.XXX.XXX.XXX.X.X.XXXXXXX.X.X
X.....X.X.........X.....X.....X.X...X...X.......X...X.....X...X.....X.....X...X.X.....X.X...X.....X.X
XXXXX.X.XXXXXXXXXXX.XXXXX.XXXXX.XXXXXXX.XXXXXXX.XXX.XXX.XXXXX.X.X.XXX.XXXXX.XXX.XXXXX.X.X.X.X.XXXXX.X
X.X...X.........X.....X...X...X.......X.X.........X...X.X.X.X...X.X...X...X.....X...X...X.X.X.....X.X
X.X.XXXXX.XXXXX.X.XXX.X.XXX.X.X.XXX.X.X.XXXXXXXXXXXXX.X.X.X.XXXXX.X.XXX.XXXXX.XXX.X.XXXXXXX.XXXXX.X.X
X...X...X...X...X.X...X.X...X...X...X.X.....X.....X...X.X.....X...X.X.........X...X.......X.....X.X.X
X.XXX.X.XXX.XXXXX.X.X.X.XXXXX.XXX.XXX.XXXXX.X.XXX.XXX.X.XXXXX.X.XXX.X.XXXXX.X.X.XXXXXXXXX.X.XXX.X.X.X
X.X...X.X.X.X.....X.X.X.....X.X...X.X.....X.X.X...X...X.......X...X.X.....X.X.X.X.......X.X...X...X.X
X.XXXXX.X.X.X.XXXXX.X.XXXXX.XXX.XXX.XXX.XXX.X.X.XXX.XXXXXXX.XXXXX.X.XXXXXXX.X.X.X.XXXXX.X.XXXXX.XXX.X
X.........X...X.....X.X...X.....X...X.X...X.X.X...X.....X...X...X.......X...X.X...X.X...X.X...X...X.X
XXXXX.XXXXXXXXX.XXXXX.X.X.XXXXXXX.X.X.XXX.X.X.XXX.XXX.X.XXXXX.X.XXXXXXX.X.XXX.XXX.X.X.XXX.X.X.X.XXX.X
X.......X.......X.....X.X.....X.X.X...X...X...X.X...X.X.X.....X.....X.X...X.....X...X.X...X.X.X.X...X
X.XXXXXXX.XXXXXXX.XXXXXXX.XXX.X.X.XXX.X.XXXXXXX.XXX.XXX.X.XXXXXXXXX.X.XXXXX.XXXXXXXXX.X.XXX.X.XXX.X.X
X.X...X...X.....X.X.....X...X.X.....X.X.X.X.....X.X...X.......X.....X.X...X.X.........X.....X.X...X.X
XXX.X.X.XXX.XXX.X.X.XXX.XXX.X.XXXXX.XXX.X.X.XXX.X.XXX.XXXXXXXXX.XXXXX.X.X.X.X.XXXXXXXXXXXXXXX.X.XXX.X
X...X...X.....X.....X.....X.X.....X...X.X.....X.....X.........X...X...X.X...X.....X...X.....X.X...X.X
X.XXXXX.XXXXXXXXXXXXXXXXX.X.XXXXX.X.X.X.XXXXX.XXXXX.XXXXXXXXX.X.X.X.XXX.XXXXXXX.X.X.X.X.XXXXX.X.X.X.X
X.....X.X.....X.........X...X...X.X.X.X...X...X.X...X.......X.X.X.X.....X.....X.X...X.X.......X.X.X.X
X.XXX.XXX.XXX.X.XXXXXXX.XXXXX.X.X.X.X.XXX.XXX.X.X.X.XXXXX.XXX.X.X.X.XXXXXXX.X.XXXXXXX.X.XXXXXXX.X.X.X
X...X.....X.X...X.X...X.X.....X.X...X...X...X...X.X.....X.X...X.X.X.X.......X.X.......X.X.......X.X.X
XXX.XXXXXXX.XXXXX.X.XXX.X.XXXXX.XXXXXXX.XXX.X.XXX.XXXXX.X.X.XXXXX.X.XXXXX.XXX.X.XXXXXXX.XXXXXXX.X.XXX
X.X.X...........X...X...X.X...X.X.........X.X.X...X...X.X.X.X.....X.....X...X.X.X...X...X.....X.X...X
X.X.X.XXXXXXX.X.X.XXX.X.X.X.XXX.XXXXXXXXX.X.XXX.XXX.XXX.X.X.X.X.XXXXXXX.XXX.X.X.X.XXX.XXX.XXX.X.XXX.X
X.X.X.X.....X.X.....X.X.X.X.X...X.......X.X...X...X.......X.X.X.X.....X.....X.X.X...X.X...X...X...X.X
X.X.X.X.XXX.XXXXXXXXX.XXX.X.X.XXX.XXXXX.XXXXX.XXX.X.XXXXXXX.XXX.X.XXXXXXXXXXX.X.X.XXX.X.XXXXX.XXX.X.X
X...X.....X.........X.X.....X.X.....X.......X.X...X.X.X...X.....X...........X.X.X...X.X.X...X.X...X.X
X.XXXXXXXXX.XXXXXXX.X.X.XXXXX.X.XXXXX.XXXXXXX.X.XXX.X.X.X.XXXXXXX.XXXXXXX.XXX.X.XXX.X.X.X.X.X.XXX.X.X
X...X.....X.......X.X.X.....X.......X.X...X...X...X...X.X...X.....X.....X.....X.X...X...X.X.X...X.X.X
XXX.X.XXX.XXXXXXX.X.X.XXXXX.XXXXXXX.X.X.X.X.XXX.X.XXXXX.X.X.X.XXXXXXX.XXXXX.XXX.X.XXXXX.X.X.XXX.XXX.X
X...X...X.X...X...X.X.X.X...X.....X.X...X.X.X...X.......X.X.X.X.......X...X...X.X.......X.X.X...X...X
X.XXXXX.X.X.XXX.XXX.X.X.X.XXX.XXX.XXXXXXX.X.X.XXXXXXXXX.X.XXX.X.X.XXXXX.X.X.XXX.XXXXX.XXX.X.XXX.X.XXX
X.....X.X.X.....X...X.....X.X.X.X.X.....X.X.X.....X...X.X.....X.X.....X.X.X.X...X...X...X.X...X.....X
XXXXX.X.X.XXXXXXX.X.XXXXXXX.X.X.X.X.XXX.X.X.XXX.XXX.X.XXXXX.XXXXXXXXX.X.X.XXX.X.X.X.XXXXX.XXX.XXXXX.X
X.X...X.X.....X...X...X.....X.X.X...X.....X...X.X...X.....X.X...X.....X.X.....X.X.X...X...X...X...X.X
X.X.XXX.XXXXX.X.XXXXX.XXX.X.X.X.XXXXX.XXXXXXX.XXX.XXXXXXX.X.X.X.X.XXX.X.XXXXXXX.X.XXX.X.XXX.XXX.XXX.X
X...X...X.......X...X.....X.X.X.....X...X...X...X.....X.X.X...X...X...X.......X.X...X...X...X.X.....X
X.XXX.XXXXX.XXXXXXX.XXXXXXX.X.XXXXX.XXX.X.X.XXX.XXX.X.X.X.XXXXXXXXX.XXXXXXXXX.XXXXX.XXXXX.XXX.X.XXXXX
X...X.X...X...X...X.X.....X.X.X.......X.X.X...X...X.X.X.X.X.....X.........X.X.X.....X.....X.....X...X
X.XXX.X.X.XXXXX.X.X.X.X.XXX.X.X.XXXXX.X.X.XXX.XXX.XXX.X.X.X.XXX.XXXXXXXXX.X.X.X.XXXXX.XXXXX.XXXXX.X.X
X.....X.X.......X.X...X.....X.X.....X.X...X.....X.X...X.X...X.X.....X.....X.X...X...X...X.......X.X.X
XXXXXXX.XXXXXXXXX.XXXXXXXXXXX.X.XXX.XXXXX.XXXXX.X.X.XXX.XXXXX.XXXXX.XXXXX.X.XXXXX.X.XXX.XXXXXXX.X.XXX
X.......X.......X.X...........X...X.......X...X.X...X.......X.....X...X.....X.....X...X.....X...X...X
X.XXXXX.XXXXX.X.X.XXX.XXXXXXXXXXX.XXXXXXXXX.X.X.XXXXX.X.XXXXXXX.X.XXX.XXXXXXX.XXXXXXX.XXX.X.XXX.XXX.X
X.X...X.X...X.X.....X.X.....X...X.X.X.......X.X.......X...X.....X...X.........X.X...X...X.X.X...X...X
X.X.XXX.X.X.XXXXXXX.X.X.XXX.XXX.X.X.X.XXXXXXX.XXXXXXXXXXX.X.XXXXXXX.XXXXXXXXXXX.X.X.XXX.X.X.XXX.X.X.X
X.X.....X.X.......X...X...X...X.....X.X.....X.....X.....X.X.X.....X...X.X.......X.X...X.X.X...X...X.X
X.XXXXXXX.XXXXXXX.X.XXX.XXXXX.X.XXX.X.X.X.XXXXXXX.X.XXXXX.X.X.XXX.XXX.X.X.XXX.XXX.XXX.X.XXX.X.XXXXXXX
X...X.....X.....X.X.X...X.....X.X...X.X.X.......X.X.....X...X...X.....X.....X.......X.X...X.X.X.....X
X.X.X.XXXXX.XXX.X.XXX.XXX.XXXXXXX.XXX.XXXXX.XXXXX.XXXXX.XXXXX.XXXXXXXXX.XXXXXXXXXXXXX.XXX.X.X.X.XXX.X
X.X...X...X.X...X.....X.X...X...X.X...X.....X...X...X.........X.........X.X.........X.....X.X.X.X.X.X
X.XXXXX.XXX.X.XXXXXXXXX.XXX.X.X.XXX.XXX.XXXXX.X.X.X.XXX.XXXXXXX.XXXXXXXXX.XXX.XXX.XXXXXXXXX.X.X.X.X.X
X.X...X.....X.....X.....X...X.X...X.X...X.....X.X.X...X.X.X.....X.....X.....X...X.X.....X...X...X.X.X
X.XXX.X.XXXXXXX.X.XXX.XXX.X.X.X.XXX.X.X.X.XXXXX.XXXXX.X.X.X.XXXXX.X.XXXXX.X.XXX.XXX.XXX.X.XXXXXXX.X.X
X...X.........X.X.....X...X.X.X...X.X.X.X.X...X.X...X.X.X.X.X.X...X.......X...X.....X.X...X...X...X.X
XXX.X.XXXXXXXXX.XXX.XXX.XXXXX.XXX.X.X.XXX.X.XXX.X.X.X.X.X.X.X.XXXXXXX.XXXXXXX.X.XXXXX.XXXXX.X.X.XXX.X
X...X...X.......X.X...X.....X.X.X...X...X.X.X...X.X...X...X...X...X...X.......X.X.........X.X.X.X...X
X.XXXXXXX.XXXXXXX.XXX.XXXXX.X.X.XXXXXXX.X.X.X.XXX.XXXXXXXXXXX.X.X.X.XXXXX.XXXXX.XXXXXXXXX.X.X.X.X.XXX
X...X.....X.......X...X...X...X...X.....X.X.....X.......X.....X.X.X.....X...X...............X...X...X
XXX.X.X.XXXXX.XXXXX.XXX.XXXXXXX.XXX.X.XXX.XXXXX.XXXXXXX.X.XXXXX.X.XXXXX.XXX.XXXXXXXXXXXXXXXXX.XXXXX.X
X.X.X.X.X.....X...X.X.......X.......X...X...X...X.....X.X.X.....X.......X.X.X.......X.....X...X...X.X
X.X.XXX.X.XXX.X.X.X.XXXXX.XXX.XXXXXXXXX.XXX.X.XXXXX.X.X.X.X.X.XXXXXXXXXXX.X.X.XXXXX.XXX.X.X.XXX.X.X.X
X...X...X...X.X.X.X.....X.....X...X.......X.X.......X...X.X.X.X.........X...X.X...X...X.X.....X.X...X
X.XXX.XXX.X.XXX.X.XXXXX.X.XXXXXXX.X.XXXXX.X.XXX.XXXXXXXXX.X.X.XXX.X.XXXXX.XXX.X.XXXXX.XXXXXXX.X.XXX.X
X.X...X...X.....X...X...X...X.....X.....X.X.X...X.........X.X...X.X.X.....X...X.......X.....X.X...X.X
X.X.XXX.XXXXXXXXXXX.X.XXXXX.XXX.XXXXXXX.X.X.X.XXX.XXXXXXXXXXXXX.XXX.X.XXXXXXX.X.XXXXXXX.X.X.XXXXX.XXX
X...X.X...X.......X.X.....X...X.X...X...X.X.X...X.X...X.........X...X...X.....X...X...X.X.X...X.....X
XXXXX.XXX.X.XXX.X.X.XXXXX.XXX.X.X.X.X.XXXXX.XXXXX.XXX.X.XXX.XXXXX.X.XXX.X.XXXXXXX.X.XXX.X.XXX.X.XXX.X
X.....X...X...X.X.X...X...X.....X.X.X.X...X.......X...X.X...X.....X...X...X.......X...X.X.X.....X.X.X
X.X.XXX.XXXXXXX.XXXXX.X.XXXXX.XXX.X.X.X.X.XXXXXXXXX.XXX.X.XXX.XXXXX.XXXXXXX.XXXXXXX.X.X.X.XXXXXXX.X.X
X.X.X...X.......X...X.X.X...X.X...X.X...X...X...X.....X.X.X.X...X...X.....X...X...X.X...X.......X...X
X.X.X.XXX.X.XXXXX.X.X.X.X.X.XXX.XXX.XXX.X.XXX.XXX.XXX.X.X.X.X.X.XXXXX.XXX.XXX.X.X.X.XXXXX.XXXXX.X.XXX
X.X.X.X...X.X.....X...X...X.....X.X...X.X...X.......X.X.X.X...X.X...X.X.X...X...X.X.X...X.X...X.X...X
X.X.X.X.XXX.X.X.XXXXX.XXXXXXXXXXX.XXX.XXX.X.X.XXXXXXX.X.X.XXXXX.X.X.X.X.X.XXXXXXX.XXX.X.X.X.XXX.XXX.X
X.X.X...X.X.X.X.X...X.X.......X...X.X...X.X.....X...X...X...X...X.X...X.X.......X...X.X.X...X...X...X
X.X.XXX.X.X.X.XXX.X.XXX.XXX.XXX.X.X.XXX.XXXXXXXXX.X.XXXXXXX.X.XXX.XXXXX.XXX.X.XXXXX.X.X.XXXXX.XXX.X.X
X.X.....X...X.....X.....X.......X.................X.........X.............X.X.........X.......X...X.X
XXXXXXXXXXXXXXXXXXXXXXXXXXXXXXXXXXXXXXXXXXXXXXXXXXXXXXXXXXXXXXXXXXXXXXXXXXXXXXXXXXXXXXXXXXXXXXXXXXXXX
