1
XXXXXXXXXXXXXXXXXXXXXXXXXXXXXXXXXXXXXXXXXXXXXXXXXXXXXXXXXXXXXXXXXXXXXXXXXXXXXXXXXXXXXXXXXXXXXXXXXXXXX
X.X...........X.....X...X.............X...X.....X.........X.........X.....X.........X.....X.........X
X.XXX.XXXXXXX.X.XXX.X.X.X.XXXXXXX.XXX.X.XXX.XXXXX.X.XXXXX.X.XXXXX.X.X.XXX.X.XXX.XXX.XXX.X.XXXXXXXXX.X
X...X...X...X...X.X.X.X.X.X.......X.X.X.......X...X.....X.X.....X.X.X.X.X.....X.X.X.....X.X.........X
XXX.XXX.XXX.XXX.X.X.X.X.X.X.XXXXXXX.X.X.XXXXX.X.XXXXXXX.XXX.XXXXX.XXX.X.XXXXXXX.X.XXXXXXX.X.XXXXXXXXX
X.X...X.....X...X...X.X...X.X.....X...X.....X.X.......X.....X...X.......X...X...X.X.....X.X.........X
X.XXX.X.XXXXX.XXX.XXXXXXXXX.X.XXXXX.XXX.XXXXX.XXX.XXXXXXXXXXX.X.XXXXXXX.X.X.X.XXX.X.X.XXX.XXXXXXXXX.X
X...X.X.X...X.X.X.X.........X.....X.X...X.......X.X.........X.X.X...X.....X.X...X...X.........X.....X
X.XXX.XXX.X.X.X.X.XXX.XXXXXXXXX.X.X.XXXXX.XXXXXXX.X.XXXXXXX.X.X.X.X.XXXXXXXXXXX.X.XXXXXXXXXXX.X.XXX.X
X...X...X.X.X.X.....X...X...X...X.X.....X.....X...X.X.......X.X...X...X.........X...X.....X.X.X.X...X
X.X.XXX.X.X.X.XXXXX.XXX.X.X.X.X.X.XXXXX.X.XXX.X.XXX.X.XXXXXXX.XXXXXXX.X.XXXXXXXXXXX.X.XXX.X.X.X.X.XXX
X.X.....X.X...X...X...X.X.X.X.X.X.X...X.X.X.X...X...X.........X.....X.X...X...X.....X...X.X.....X...X
X.XXXXXXX.XXX.X.X.XXX.X.X.X.X.XXXXXXX.X.X.X.XXXXX.XXXXXXXXXXXXX.XXX.X.XXX.X.X.XXXXXXXXX.X.XXXXX.XXXXX
X.......X...X.X.X.X...X.X.X.X.........X.X...X...X...X...........X...X.X.X...X...........X...X...X...X
XXXXXXX.X.X.X.X.X.X.XXX.X.X.X.XXXXX.XXX.X.XXX.X.XXX.X.XXXXXXX.XXXXX.X.X.XXXXX.XXXXXXXXXXXXX.XXXXX.X.X
X.......X.X.X.X.X.X...X...X.X.....X...X.X...X.X.....X...X...X.X...X.X.......X...X.....X...X.......X.X
X.XXXXXXX.X.XXX.X.XXX.XXXXX.XXXXXXX.X.X.XXXXX.XXXXXXXXX.X.X.XXX.X.XXXXXXXXX.XXX.X.X.X.XXX.XXXXXXXXX.X
X.....X.X.X.....X.X.X.......X.......X.X.....X.X...X.....X.X.....X.......X...X.X.X.X.X...X.......X.X.X
XXXXX.X.X.XXXXXXX.X.XXXXXXXXX.XXXXXXX.XXXXX.X.X.XXXXX.XXX.XXXXXXX.XXXXXXX.XXX.X.XXX.XXX.XXX.XXX.X.X.X
X...X.X...X...X...X.........X.....X...X...X...X...X.......X...X.X.X.....X...X.X.....X.X...X.X.X...X.X
X.XXX.X.XXX.X.X.XXX.X.XXX.X.XXXXX.X.XXX.X.XXXXX.X.X.XXXXXXX.X.X.X.X.XXX.XXX.X.XXXXXXX.XXX.X.X.XXX.X.X
X.....X.X...X...X...X...X.X.......X.....X.X...X.X...X.....X.X...X...X.X...X.X...............X.X...X.X
XXX.XXX.X.X.XXXXXXX.XXXXX.XXXXXXXXXXX.XXXXX.XXX.XXXXX.XXX.X.X.XXXXXXX.XXX.X.XXXXXXXXXXXXXXXXX.X.XXX.X
X.X.X.X.X.X.X.....X.X...X...........X.X.....X...X...X...X...X.X.........X...X.......X...X...X...X.X.X
X.X.X.XXX.X.X.XXX.X.X.X.XXXXXXXXXXX.XXX.X.X.X.XXXXX.X.X.XXXXX.X.XXXXXXX.XXXXX.XXXXX.X.X.X.XXX.XXX.X.X
X.X...X...X.X...X.X.X.X.X.......X.......X.X.X.....X...X.....X.X.X.....X.....X.....X...X.X...X.X...X.X
X.XXX.X.XXXXX.XXX.X.X.X.X.XXXXX.XXXXX.XXX.XXXXXXX.XXXXXXXXX.XXX.X.XXX.X.XXX.X.XXX.XXXXX.X.X.X.X.X.X.X
X.....X.......X...X.X.X.X.....X.....X.X.X.....X.X.........X.......X.X.X.X.X.X.X.X.X...X.X.X.....X.X.X
XXX.XXXXXXXXXXX.XXX.X.X.XXXXX.XXXXX.X.X.XXX.X.X.XXXXXXXXX.XXX.XXXXX.X.X.X.X.X.X.X.X.X.X.XXXXXXX.XXX.X
X.X.....X.......X...X.X.......X...X.X...X...X.X.........X...X.X...X...X.X.X.X...X.X.X.....X...X...X.X
X.XXXXX.XXX.X.XXX.XXX.XXXXXXXXX.X.X.XXX.X.XXX.X.XXXXXXX.XXX.XXX.X.X.XXX.X.X.XXX.X.XXXXXXX.X.X.XXX.X.X
X.....X...X.X...X.X.X.......X.X.X...X...X.X...X...X...X.X.X.....X.X...X.X...X...X.......X...X.X...X.X
XXXXX.XXX.XXXXX.X.X.XXXXXXX.X.X.XXXXXXXXX.X.XXXXX.X.X.X.X.XXXXXXX.XXXXX.XXX.XXX.XXXXXXX.XXXXX.X.XXX.X
X.X.....X.......X.........X.X.............X...X...X.X.X...X.....X.....X...X...X.X.....X...X...X...X.X
X.X.X.XXXXXXXXXXXXX.XXXXX.X.XXXXXXXXXXXXXXXXX.X.XXX.X.XXX.X.XXX.XXXXX.XXX.XXX.XXX.XXX.XXX.X.XXX.XXX.X
X...X.X.....X.....X.X...X.X...X.............X...X...X.X...X.X...X...X.....X...X.....X.X...X.X...X...X
X.XXX.X.X.X.X.X.X.XXX.X.X.XXX.XXXXX.XXX.XXXXXXXXXXX.XXX.XXX.X.X.X.X.XXXXXXX.XXXXXXX.X.X.XXX.X.XXX.X.X
X...X.X.X.X.X.X.X...X.X.X...X.....X.X.X.......X...X.....X.X.X.X.X.X...X.X...X.....X.X...X.X.X.X...X.X
XXX.X.X.X.X.X.X.XXX.X.X.XXX.XXXXX.X.X.XXXXXXX.X.X.X.XXXXX.XXX.XXX.XXX.X.X.XXXXX.X.X.XXXXX.X.XXX.XXXXX
X.X.X.X.X.X.X.X...X...X.X.......X.X.........X.X.X.X.X...X.....X.....X...X...X...X.X.X.....X.......X.X
X.X.X.X.X.XXX.XXX.XXXXX.X.XXXXXXX.XXXXXXXXX.X.X.X.X.XXX.X.XXXXX.XXXXX.XXXXX.X.XXX.X.X.XXX.XXXXXXX.X.X
X...X...X.....X...X...X.X.X.....X.X...X.....X...X.X...X.......X.....X.X.....X.X...X.X...X.........X.X
XXXXXXXXXXXXX.X.XXX.X.X.XXX.XXX.X.X.X.X.XXXXXXXXX.XXX.XXX.XXX.XXXXX.X.X.XXXXX.X.XXX.XXXXXXXXX.XXXXX.X
X...........X.X.....X.X.....X.X...X.X...........X.......X.X.....X...X...X.....X...X.X...X...X.......X
X.X.XXXXXXX.XXXXXXXXX.XXXXXXX.XXXXX.XXXXXXXXXXXXXXXXXXX.X.X.XXX.X.XXXXXXX.XXXXXXX.X.X.X.X.X.XXXXXXX.X
X.X.X...X.X.........X.X...X...X...X.X.X.......X.....X.X.X.X...X.X.....X...X.....X.X.X.X...X.X...X.X.X
X.XXX.X.X.XXXXXXXXX.X.X.X.XXX.X.X.X.X.X.XXX.X.X.XXX.X.X.XXXXX.XXXXXXX.X.XXXXX.XXX.X.X.XXXXX.X.X.X.X.X
X.....X.X.......X.....X.X...X...X.X...X...X.X.X...X.X...X.....X...X...X.X...X...X.X.X...X...X.X...X.X
XXXXXXX.XXX.X.X.X.XXXXX.XXX.XXXXX.XXX.XXX.XXX.XXX.X.XXX.X.X.XXX.X.X.XXX.X.X.X.X.X.X.XXX.X.XXX.XXXXX.X
X.....X.X...X.X.X.X.X...X.X.....X.......X.X.X...X.X...X...X.X...X.X.X.X...X.X.X...X...X.X.X.X.......X
X.XXX.XoX.X.XXXXX.X.X.XXX.XXXXX.XXXXXXXXX.X.X.XXX.XXX.XXXXX.X.XXX.X.X.X.XXX.X.XXXXX.X.X.X.X.X.XXXXXXX
X.X.....X.X.........X.....X...X.X.......X.X.X.....X.X.X.....X...X.X.X.X...X.X...X...X.X.X.X.........X
X.XXXXXXX.XXXXXXXXXXXXXXX.XXX.X.X.XXXXX.X.X.XXXXXXX.X.XXXXXXXXX.X.X.X.XXX.X.XXX.XXX.X.X.X.XXXXXXXXX.X
X.....X...X...X.....X.....X...X...X.X...X.X.X.......X...X.....X.X...X.....X...X...X.X...X.......X.X.X
XXX.X.X.XXXXX.X.XXX.X.XXXXX.X.XXXXX.X.XXX.X.X.X.XXXXXXX.X.XXX.X.XXXXX.XXXXXXX.XXX.XXX.XXX.XXXXX.X.X.X
X...X.X.X...X.X...X.X...X...X.X...X.X...X.X.X.X...X.....X.X.X.X...X...X.......X.....X...X.X.....X...X
X.XXX.X.X.X.X.XXX.X.XXX.X.XXX.X.X.X.XXX.X.X.X.XXX.X.XXX.X.X.X.XXX.XXXXX.XXXXXXXXXXX.XXXXXXX.XXXXX.XXX
X.X...X...X.X.X...X.....X...X.X.X.X...X...X...X...X.X...X...X...X.......X...X.......X.......X.....X.X
XXX.XXXXXXX.X.X.XXXXXXXXX.X.X.X.X.XXX.XXXXX.XXX.X.X.X.XXXXX.XXX.XXXXXXXXX.X.X.XXXXXXX.XXXXXXXXX.XXX.X
X...X...X...X.X.......X...X.X...X.....X...X.X...X.X.X.....X.X.X...........X.X.....X...X.........X...X
X.XXX.X.X.XXX.XXXXXXX.X.XXX.XXXXXXXXX.X.XXXXX.XXXXX.XXXXX.X.X.X.XXXXXXXXXXXXXXXXX.X.X.XXXXX.XXXXX.X.X
X.X...X.X.X.....X.....X...X.X...X...X.X.....X.X...X...X.X.X.X.X.......X...........X.X.....X...X...X.X
X.X.XXXXX.X.XXXXX.XXXXXXXXX.X.XXX.X.X.XXX.X.X.X.X.XXX.X.X.X.X.XXXXXXX.X.XXXXXXXXXXX.XXXXX.XXX.X.XXX.X
X.X.......X.....X...X...X...X.X...X...X...X.X.X.X.....X...X.....X...X...X...X.........X...X.X.X.X...X
X.XXX.XXXXX.XXX.XXX.X.X.XXX.X.X.XXXXXXX.XXX.X.X.XXXXXXXXXXXXXXX.X.XXXXXXXXX.X.XXXXXXX.X.XXX.X.XXX.X.X
X...X.....X...X...X...X.....X.X.X.......X.X...X.................X.....X.X.....X.....X.X.X...X...X.X.X
X.X.XXXXX.XXX.XXX.XXXXXXXXXXX.X.XXX.X.XXX.X.XXXXXXXXXXXXXXXXXXXXX.X.X.X.X.XXXXX.XXX.XXX.X.X.XXX.X.XXX
X.X.X.....X...X...X...X.......X...X.X.X.X...X...................X.X.X...X...X...X.X.X...X.X.....X...X
X.X.X.XXXXX.XXX.XXX.X.XXXXX.X.XXX.XXX.X.X.XXX.XXXXXXX.XXX.XXXXX.XXX.X.XXXXX.X.XXX.X.X.XXX.XXXXXXXXX.X
X.X.X...X.....X...X.X.....X.X...X.X...X.....X.X.....X...X.X...X.....X.X...X.X...X.....X.X...X.....X.X
X.X.XXX.XXXXXXX.X.X.X.XXX.X.XXX.X.X.XXXXXXXXX.X.XXXXXXX.XXX.X.XXXXXXXXX.X.X.XXX.XXXXXXX.XXX.XXX.X.X.X
X.X.X.X.X.......X.X.X.X.X...X...X.X...X.....X...X.....X.....X.....X...X.X...X.X.....X.....X.X...X...X
XXX.X.X.X.XXXXX.XXX.X.X.X.XXXXXXX.X.X.X.XXX.XXX.X.XXX.X.XXXXXXXXX.X.X.X.XXXXX.XXXXX.X.X.XXX.X.X.XXXXX
X...X.....X...X.X...X.X...X.....X.X.X...X.X.X...X.X.X.X.........X...X.X...X...X...X.X.X.....X.X.X...X
X.XXXXXXXXX.X.X.X.XXX.XXXXX.XXX.X.X.XXXXX.X.X.XXX.X.X.XXXXXXXXX.XXXXX.XXX.X.XXX.X.X.XXXXXXX.X.XXX.X.X
X.........X.X.X.X.X.X.......X.X...X.X.....X.....X.X...X...X...X...X.....X.X.....X.X.......X...X...X.X
X.XXXXXXX.X.X.X.X.X.XXXXXXXXX.XXXXX.X.XXX.XXXXXXX.X.X.X.X.X.X.XXXXX.XXXXX.X.XXXXX.XXXXXXX.X.XXX.XXX.X
X...X...X.X.X...X.X.......X.........X...X.X...X...X.X...X...X.....X.......X...X.....X.X...X.X...X...X
XXX.X.X.X.XXXXXXX.X.X.XXX.X.XXXXXXXXX.X.XXX.X.X.XXXXXXXXXXXXXXXXX.XXX.XXXXXXXXX.XXX.X.X.XXXXX.XXX.X.X
X...X.X...X.......X.X...X.X.X.......X.X...X.X...X...X.X.........X.X.X.X.......X.X.X.X.X.........X.X.X
X.XXX.XXX.X.XXXXXXXXXXX.XXX.X.XXXXX.XXXXX.X.XXXXX.X.X.X.XXXXX.X.X.X.X.X.XXX.X.X.X.X.X.XXXXXXXXX.X.XXX
X...X...X.X.....X.....X.X...X...X.X.X...X.X.X...X.X.X.....X...X.X.X...X...X.X...X.......X.X...X.X...X
X.X.XXX.XXXXXXX.X.X.X.X.X.XXXXX.X.X.X.X.X.X.X.X.X.X.XXXXX.X.XXX.X.X.XXXXX.X.XXXXXXXXXXX.X.X.X.X.XXX.X
X.X...X.X.......X.X.X.X.X.......X.X.X.X.X.X.X.X...X...X...X...X.X.X.....X.X...X...X...X...X.X.X...X.X
XXXXXXX.X.XXXXXXXXX.X.X.XXXXXXXXX.X.X.X.X.X.X.XXXXXXX.XXXXXXX.XXX.XXXXX.XXXXX.X.X.X.X.XXXXX.X.XXXXX.X
X.......X.....X...X.X.X...............X...X.....X...X.X.......X...X...X.......X.X...X.....X.X.X...X.X
X.XXX.XXXXXXX.X.X.X.X.XXXXXXXXXXXXXXXXXXXXX.XXXXX.X.X.XXX.XXXXX.XXX.X.X.XXXXXXX.XXXXXXXXX.X.X.X.X.X.X
X.X...X.....X...X...X.....X...............X.X.....X...X...X...X.X...X.X.X.X.....X.....X.X...X.X.X.X.X
X.XXXXX.XXX.XXXXXXXXXXXXX.X.XXXXXXXXXXXXX.X.X.XXXXXXXXX.XXX.X.X.X.XXXXX.X.X.XXXXXXX.X.X.X.XXX.X.X.X.X
X.......X.X.........X.....X...........X...X.X.X.........X...X...X...X...X.X.......X.X...X.X.X.X.X...X
X.XXXXXXX.XXXXX.XXX.X.XXXXXXXXX.XXXXX.X.XXX.X.XXXXXXX.XXX.XXXXXXXXX.X.XXX.XXXXXXX.XXX.XXXXX.X.X.X.XXX
X...X.....X.....X...X.X...X...X.X.....X...X.X.......X...X.X.X.....X.X.X.X.X...X.X...X.......X...X...X
XXX.X.XXX.X.XXXXXXXXX.X.X.X.X.XXX.XXXXXXX.X.XXXXXXX.X.XXX.X.X.XXX.X.X.X.X.X.X.X.XXX.X.XXXXX.XXXXXXX.X
X.X...X...X.X.........X.X...X...X.......X.X...X.....X...X.X...X...X...X.....X...X...X.X...X.......X.X
X.XXXXX.XXX.X.XXXXXXXXX.XXXXXXX.XXXXXXX.X.XXXXX.XXXXX.X.X.XXX.X.XXX.XXX.XXXXXXX.X.XXXXX.X.XXX.XXXXX.X
X.....X...X...X.X.......X...X.X.....X...X.......X.....X.X.....X.X.......X...X...X.X.....X.....X...X.X
XXX.XXXXX.XXXXX.X.XXXXX.X.X.X.XXXXX.X.XXXXXXXXXXX.XXXXX.XXXXXXX.XXXXXXXXX.X.XXXXX.X.X.XXXXXXXXX.X.X.X
X.X.......X.X.....X...X...X.X.X.....X.....X.......X...X.......X...........X.X...X.X.X.X.......X.X...X
X.X.XXXXXXX.XXXXXXX.X.XXXXX.X.X.XXXXXXXXX.X.XXXXXXX.X.XXXXX.X.XXXXXXXXXXXXX.X.X.X.X.X.X.XXXXX.X.XXX.X
X...................X.......X.............X.........X.....X.X.................X...X.X.......X.....X.X
XXXXXXXXXXXXXXXXXXXXXXXXXXXXXXXXXXXXXXXXXXXXXXXXXXXXXXXXXXXXXXXXXXXXXXXXXXXXXXXXXXXXXXXXXXXXXXXXXXXXX
2
XXXXXXXXXXXXXXXXXXXXXXXXXXXXXXXXXXXXXXXXXXXXXXXXXXXXXXXXXXXXXXXXXXXXXXXXXXXXXXXXXXXXXXXXXXXXXXXXXXXXX
XXXXXXXXXXXXXXXXXXXXXXXXXXXXXXXXXXXXXXXXXXXXXXXXXXXXXXXXXXXXXXXXXXXXXXXXXXXXXXXXXXXXXXXXXXXXXXXXXXXXX
XXXXXXXXXXXXXXXXXXXXXXXXXXXXXXXXXXXXXXXXXXXXXXXXXXXXXXXXXXXXXXXXXXXXXXXXXXXXXXXXXXXXXXXXXXXXXXXXXXXXX
XXXXXXXXXXXXXXXXXXXXXXXXXXXXXXXXXXXXXXXXXXXXXXXXXXXXXXXXXXXXXXXXXXXXXXXXXXXXXXXXXXXXXXXXXXXXXXXXXXXXX
XXXXXXXXXXXXXXXXXXXXXXXXXXXXXXXXXXXXXXXXXXXXXXXXXXXXXXXXXXXXXXXXXXXXXXXXXXXXXXXXXXXXXXXXXXXXXXXXXXXXX
XXXXXXXXXXXXXXXXXXXXXXXXXXXXXXXXXXXXXXXXXXXXXXXXXXXXXXXXXXXXXXXXXXXXXXXXXXXXXXXXXXXXXXXXXXXXXXXXXXXXX
XXXXXXXXXXXXXXXXXXXXXXXXXXXXXXXXXXXXXXXXXXXXXXXXXXXXXXXXXXXXXXXXXXXXXXXXXXXXXXXXXXXXXXXXXXXXXXXXXXXXX
XXXXXXXXXXXXXXXXXXXXXXXXXXXXXXXXXXXXXXXXXXXXXXXXXXXXXXXXXXXXXXXXXXXXXXXXXXXXXXXXXXXXXXXXXXXXXXXXXXXXX
XXXXXXXXXXXXXXXXXXXXXXXXXXXXXXXXXXXXXXXXXXXXXXXXXXXXXXXXXXXXXXXXXXXXXXXXXXXXXXXXXXXXXXXXXXXXXXXXXXXXX
XXXXXXXXXXXXXXXXXXXXXXXXXXXXXXXXXXXXXXXXXXXXXXXXXXXXXXXXXXXXXXXXXXXXXXXXXXXXXXXXXXXXXXXXXXXXXXXXXXXXX
XXXXXXXXXXXXXXXXXXXXXXXXXXXXXXXXXXXXXXXXXXXXXXXXXXXXXXXXXXXXXXXXXXXXXXXXXXXXXXXXXXXXXXXXXXXXXXXXXXXXX
XXXXXXXXXXXXXXXXXXXXXXXXXXXXXXXXXXXXXXXXXXXXXXXXXXXXXXXXXXXXXXXXXXXXXXXXXXXXXXXXXXXXXXXXXXXXXXXXXXXXX
XXXXXXXXXXXXXXXXXXXXXXXXXXXXXXXXXXXXXXXXXXXXXXXXXXXXXXXXXXXXXXXXXXXXXXXXXXXXXXXXXXXXXXXXXXXXXXXXXXXXX
XXXXXXXXXXXXXXXXXXXXXXXXXXXXXXXXXXXXXXXXXXXXXXXXXXXXXXXXXXXXXXXXXXXXXXXXXXXXXXXXXXXXXXXXXXXXXXXXXXXXX
XXXXXXXXXXXXXXXXXXXXXXXXXXXXXXXXXXXXXXXXXXXXXXXXXXXXXXXXXXXXXXXXXXXXXXXXXXXXXXXXXXXXXXXXXXXXXXXXXXXXX
XXXXXXXXXXXXXXXXXXXXXXXXXXXXXXXXXXXXXXXXXXXXXXXXXXXXXXXXXXXXXXXXXXXXXXXXXXXXXXXXXXXXXXXXXXXXXXXXXXXXX
XXXXXXXXXXXXXXXXXXXXXXXXXXXXXXXXXXXXXXXXXXXXXXXXXXXXXXXXXXXXXXXXXXXXXXXXXXXXXXXXXXXXXXXXXXXXXXXXXXXXX
XXXXXXXXXXXXXXXXXXXXXXXXXXXXXXXXXXXXXXXXXXXXXXXXXXXXXXXXXXXXXXXXXXXXXXXXXXXXXXXXXXXXXXXXXXXXXXXXXXXXX
XXXXXXXXXXXXXXXXXXXXXXXXXXXXXXXXXXXXXXXXXXXXXXXXXXXXXXXXXXXXXXXXXXXXXXXXXXXXXXXXXXXXXXXXXXXXXXXXXXXXX
XXXXXXXXXXXXXXXXXXXXXXXXXXXXXXXXXXXXXXXXXXXXXXXXXXXXXXXXXXXXXXXXXXXXXXXXXXXXXXXXXXXXXXXXXXXXXXXXXXXXX
XXXXXXXXXXXXXXXXXXXXXXXXXXXXXXXXXXXXXXXXXXXXXXXXXXXXXXXXXXXXXXXXXXXXXXXXXXXXXXXXXXXXXXXXXXXXXXXXXXXXX
XXXXXXXXXXXXXXXXXXXXXXXXXXXXXXXXXXXXXXXXXXXXXXXXXXXXXXXXXXXXXXXXXXXXXXXXXXXXXXXXXXXXXXXXXXXXXXXXXXXXX
XXXXXXXXXXXXXXXXXXXXXXXXXXXXXXXXXXXXXXXXXXXXXXXXXXXXXXXXXXXXXXXXXXXXXXXXXXXXXXXXXXXXXXXXXXXXXXXXXXXXX
XXXXXXXXXXXXXXXXXXXXXXXXXXXXXXXXXXXXXXXXXXXXXXXXXXXXXXXXXXXXXXXXXXXXXXXXXXXXXXXXXXXXXXXXXXXXXXXXXXXXX
XXXXXXXXXXXXXXXXXXXXXXXXXXXXXXXXXXXXXXXXXXXXXXXXXXXXXXXXXXXXXXXXXXXXXXXXXXXXXXXXXXXXXXXXXXXXXXXXXXXXX
XXXXXXXXXXXXXXXXXXXXXXXXXXXXXXXXXXXXXXXXXXXXXXXXXXXXXXXXXXXXXXXXXXXXXXXXXXXXXXXXXXXXXXXXXXXXXXXXXXXXX
XXXXXXXXXXXXXXXXXXXXXXXXXXXXXXXXXXXXXXXXXXXXXXXXXXXXXXXXXXXXXXXXXXXXXXXXXXXXXXXXXXXXXXXXXXXXXXXXXXXXX
XXXXXXXXXXXXXXXXXXXXXXXXXXXXXXXXXXXXXXXXXXXXXXXXXXXXXXXXXXXXXXXXXXXXXXXXXXXXXXXXXXXXXXXXXXXXXXXXXXXXX
XXXXXXXXXXXXXXXXXXXXXXXXXXXXXXXXXXXXXXXXXXXXXXXXXXXXXXXXXXXXXXXXXXXXXXXXXXXXXXXXXXXXXXXXXXXXXXXXXXXXX
XXXXXXXXXXXXXXXXXXXXXXXXXXXXXXXXXXXXXXXXXXXXXXXXXXXXXXXXXXXXXXXXXXXXXXXXXXXXXXXXXXXXXXXXXXXXXXXXXXXXX
XXXXXXXXXXXXXXXXXXXXXXXXXXXXXXXXXXXXXXXXXXXXXXXXXXXXXXXXXXXXXXXXXXXXXXXXXXXXXXXXXXXXXXXXXXXXXXXXXXXXX
XXXXXXXXXXXXXXXXXXXXXXXXXXXXXXXXXXXXXXXXXXXXXXXXXXXXXXXXXXXXXXXXXXXXXXXXXXXXXXXXXXXXXXXXXXXXXXXXXXXXX
XXXXXXXXXXXXXXXXXXXXXXXXXXXXXXXXXXXXXXXXXXXXXXXXXXXXXXXXXXXXXXXXXXXXXXXXXXXXXXXXXXXXXXXXXXXXXXXXXXXXX
XXXXXXXXXXXXXXXXXXXXXXXXXXXXXXXXXXXXXXXXXXXXXXXXXXXXXXXXXXXXXXXXXXXXXXXXXXXXXXXXXXXXXXXXXXXXXXXXXXXXX
XXXXXXXXXXXXXXXXXXXXXXXXXXXXXXXXXXXXXXXXXXXXXXXXXXXXXXXXXXXXXXXXXXXXXXXXXXXXXXXXXXXXXXXXXXXXXXXXXXXXX
XXXXXXXXXXXXXXXXXXXXXXXXXXXXXXXXXXXXXXXXXXXXXXXXXXXXXXXXXXXXXXXXXXXXXXXXXXXXXXXXXXXXXXXXXXXXXXXXXXXXX
XXXXXXXXXXXXXXXXXXXXXXXXXXXXXXXXXXXXXXXXXXXXXXXXXXXXXXXXXXXXXXXXXXXXXXXXXXXXXXXXXXXXXXXXXXXXXXXXXXXXX
XXXXXXXXXXXXXXXXXXXXXXXXXXXXXXXXXXXXXXXXXXXXXXXXXXXXXXXXXXXXXXXXXXXXXXXXXXXXXXXXXXXXXXXXXXXXXXXXXXXXX
XXXXXXXXXXXXXXXXXXXXXXXXXXXXXXXXXXXXXXXXXXXXXXXXXXXXXXXXXXXXXXXXXXXXXXXXXXXXXXXXXXXXXXXXXXXXXXXXXXXXX
XXXXXXXXXXXXXXXXXXXXXXXXXXXXXXXXXXXXXXXXXXXXXXXXXXXXXXXXXXXXXXXXXXXXXXXXXXXXXXXXXXXXXXXXXXXXXXXXXXXXX
XXXXXXXXXXXXXXXXXXXXXXXXXXXXXXXXXXXXXXXXXXXXXXXXXXXXXXXXXXXXXXXXXXXXXXXXXXXXXXXXXXXXXXXXXXXXXXXXXXXXX
XXXXXXXXXXXXXXXXXXXXXXXXXXXXXXXXXXXXXXXXXXXXXXXXXXXXXXXXXXXXXXXXXXXXXXXXXXXXXXXXXXXXXXXXXXXXXXXXXXXXX
XXXXXXXXXXXXXXXXXXXXXXXXXXXXXXXXXXXXXXXXXXXXXXXXXXXXXXXXXXXXXXXXXXXXXXXXXXXXXXXXXXXXXXXXXXXXXXXXXXXXX
XXXXXXXXXXXXXXXXXXXXXXXXXXXXXXXXXXXXXXXXXXXXXXXXXXXXXXXXXXXXXXXXXXXXXXXXXXXXXXXXXXXXXXXXXXXXXXXXXXXXX
XXXXXXXXXXXXXXXXXXXXXXXXXXXXXXXXXXXXXXXXXXXXXXXXXXXXXXXXXXXXXXXXXXXXXXXXXXXXXXXXXXXXXXXXXXXXXXXXXXXXX
XXXXXXXXXXXXXXXXXXXXXXXXXXXXXXXXXXXXXXXXXXXXXXXXXXXXXXXXXXXXXXXXXXXXXXXXXXXXXXXXXXXXXXXXXXXXXXXXXXXXX
XXXXXXXXXXXXXXXXXXXXXXXXXXXXXXXXXXXXXXXXXXXXXXXXXXXXXXXXXXXXXXXXXXXXXXXXXXXXXXXXXXXXXXXXXXXXXXXXXXXXX
XXXXXXXXXXXXXXXXXXXXXXXXXXXXXXXXXXXXXXXXXXXXXXXXXXXXXXXXXXXXXXXXXXXXXXXXXXXXXXXXXXXXXXXXXXXXXXXXXXXXX
XXXXXXXXXXXXXXXXXXXXXXXXXXXXXXXXXXXXXXXXXXXXXXXXXXXXXXXXXXXXXXXXXXXXXXXXXXXXXXXXXXXXXXXXXXXXXXXXXXXXX
XXXXXXXXXXXXXXXXXXXXXXXXXXXXXXXXXXXXXXXXXXXXXXXXXXXXXXXXXXXXXXXXXXXXXXXXXXXXXXXXXXXXXXXXXXXXXXXXXXXXX
XXXXXXXoXXXXXXXXXXXXXXXXXXXXXXXXXXXXXXXXXXXXXXXXXXXXXXXXXXXXXXXXXXXXXXXXXXXXXXXXXXXXXXXXXXXXXXXXXXXXX
XXXXXXXXXXXXXXXXXXXXXXXXXXXXXXXXXXXXXXXXXXXXXXXXXXXXXXXXXXXXXXXXXXXXXXXXXXXXXXXXXXXXXXXXXXXXXXXXXXXXX
XXXXXXXXXXXXXXXXXXXXXXXXXXXXXXXXXXXXXXXXXXXXXXXXXXXXXXXXXXXXXXXXXXXXXXXXXXXXXXXXXXXXXXXXXXXXXXXXXXXXX
XXXXXXXXXXXXXXXXXXXXXXXXXXXXXXXXXXXXXXXXXXXXXXXXXXXXXXXXXXXXXXXXXXXXXXXXXXXXXXXXXXXXXXXXXXXXXXXXXXXXX
XXXXXXXXXXXXXXXXXXXXXXXXXXXXXXXXXXXXXXXXXXXXXXXXXXXXXXXXXXXXXXXXXXXXXXXXXXXXXXXXXXXXXXXXXXXXXXXXXXXXX
XXXXXXXXXXXXXXXXXXXXXXXXXXXXXXXXXXXXXXXXXXXXXXXXXXXXXXXXXXXXXXXXXXXXXXXXXXXXXXXXXXXXXXXXXXXXXXXXXXXXX
XXXXXXXXXXXXXXXXXXXXXXXXXXXXXXXXXXXXXXXXXXXXXXXXXXXXXXXXXXXXXXXXXXXXXXXXXXXXXXXXXXXXXXXXXXXXXXXXXXXXX
XXXXXXXXXXXXXXXXXXXXXXXXXXXXXXXXXXXXXXXXXXXXXXXXXXXXXXXXXXXXXXXXXXXXXXXXXXXXXXXXXXXXXXXXXXXXXXXXXXXXX
XXXXXXXXXXXXXXXXXXXXXXXXXXXXXXXXXXXXXXXXXXXXXXXXXXXXXXXXXXXXXXXXXXXXXXXXXXXXXXXXXXXXXXXXXXXXXXXXXXXXX
XXXXXXXXXXXXXXXXXXXXXXXXXXXXXXXXXXXXXXXXXXXXXXXXXXXXXXXXXXXXXXXXXXXXXXXXXXXXXXXXXXXXXXXXXXXXXXXXXXXXX
XXXXXXXXXXXXXXXXXXXXXXXXXXXXXXXXXXXXXXXXXXXXXXXXXXXXXXXXXXXXXXXXXXXXXXXXXXXXXXXXXXXXXXXXXXXXXXXXXXXXX
XXXXXXXXXXXXXXXXXXXXXXXXXXXXXXXXXXXXXXXXXXXXXXXXXXXXXXXXXXXXXXXXXXXXXXXXXXXXXXXXXXXXXXXXXXXXXXXXXXXXX
XXXXXXXXXXXXXXXXXXXXXXXXXXXXXXXXXXXXXXXXXXXXXXXXXXXXXXXXXXXXXXXXXXXXXXXXXXXXXXXXXXXXXXXXXXXXXXXXXXXXX
XXXXXXXXXXXXXXXXXXXXXXXXXXXXXXXXXXXXXXXXXXXXXXXXXXXXXXXXXXXXXXXXXXXXXXXXXXXXXXXXXXXXXXXXXXXXXXXXXXXXX
XXXXXXXXXXXXXXXXXXXXXXXXXXXXXXXXXXXXXXXXXXXXXXXXXXXXXXXXXXXXXXXXXXXXXXXXXXXXXXXXXXXXXXXXXXXXXXXXXXXXX
XXXXXXXXXXXXXXXXXXXXXXXXXXXXXXXXXXXXXXXXXXXXXXXXXXXXXXXXXXXXXXXXXXXXXXXXXXXXXXXXXXXXXXXXXXXXXXXXXXXXX
XXXXXXXXXXXXXXXXXXXXXXXXXXXXXXXXXXXXXXXXXXXXXXXXXXXXXXXXXXXXXXXXXXXXXXXXXXXXXXXXXXXXXXXXXXXXXXXXXXXXX
XXXXXXXXXXXXXXXXXXXXXXXXXXXXXXXXXXXXXXXXXXXXXXXXXXXXXXXXXXXXXXXXXXXXXXXXXXXXXXXXXXXXXXXXXXXXXXXXXXXXX
XXXXXXXXXXXXXXXXXXXXXXXXXXXXXXXXXXXXXXXXXXXXXXXXXXXXXXXXXXXXXXXXXXXXXXXXXXXXXXXXXXXXXXXXXXXXXXXXXXXXX
XXXXXXXXXXXXXXXXXXXXXXXXXXXXXXXXXXXXXXXXXXXXXXXXXXXXXXXXXXXXXXXXXXXXXXXXXXXXXXXXXXXXXXXXXXXXXXXXXXXXX
XXXXXXXXXXXXXXXXXXXXXXXXXXXXXXXXXXXXXXXXXXXXXXXXXXXXXXXXXXXXXXXXXXXXXXXXXXXXXXXXXXXXXXXXXXXXXXXXXXXXX
XXXXXXXXXXXXXXXXXXXXXXXXXXXXXXXXXXXXXXXXXXXXXXXXXXXXXXXXXXXXXXXXXXXXXXXXXXXXXXXXXXXXXXXXXXXXXXXXXXXXX
XXXXXXXXXXXXXXXXXXXXXXXXXXXXXXXXXXXXXXXXXXXXXXXXXXXXXXXXXXXXXXXXXXXXXXXXXXXXXXXXXXXXXXXXXXXXXXXXXXXXX
XXXXXXXXXXXXXXXXXXXXXXXXXXXXXXXXXXXXXXXXXXXXXXXXXXXXXXXXXXXXXXXXXXXXXXXXXXXXXXXXXXXXXXXXXXXXXXXXXXXXX
XXXXXXXXXXXXXXXXXXXXXXXXXXXXXXXXXXXXXXXXXXXXXXXXXXXXXXXXXXXXXXXXXXXXXXXXXXXXXXXXXXXXXXXXXXXXXXXXXXXXX
XXXXXXXXXXXXXXXXXXXXXXXXXXXXXXXXXXXXXXXXXXXXXXXXXXXXXXXXXXXXXXXXXXXXXXXXXXXXXXXXXXXXXXXXXXXXXXXXXXXXX
XXXXXXXXXXXXXXXXXXXXXXXXXXXXXXXXXXXXXXXXXXXXXXXXXXXXXXXXXXXXXXXXXXXXXXXXXXXXXXXXXXXXXXXXXXXXXXXXXXXXX
XXXXXXXXXXXXXXXXXXXXXXXXXXXXXXXXXXXXXXXXXXXXXXXXXXXXXXXXXXXXXXXXXXXXXXXXXXXXXXXXXXXXXXXXXXXXXXXXXXXXX
XXXXXXXXXXXXXXXXXXXXXXXXXXXXXXXXXXXXXXXXXXXXXXXXXXXXXXXXXXXXXXXXXXXXXXXXXXXXXXXXXXXXXXXXXXXXXXXXXXXXX
XXXXXXXXXXXXXXXXXXXXXXXXXXXXXXXXXXXXXXXXXXXXXXXXXXXXXXXXXXXXXXXXXXXXXXXXXXXXXXXXXXXXXXXXXXXXXXXXXXXXX
XXXXXXXXXXXXXXXXXXXXXXXXXXXXXXXXXXXXXXXXXXXXXXXXXXXXXXXXXXXXXXXXXXXXXXXXXXXXXXXXXXXXXXXXXXXXXXXXXXXXX
XXXXXXXXXXXXXXXXXXXXXXXXXXXXXXXXXXXXXXXXXXXXXXXXXXXXXXXXXXXXXXXXXXXXXXXXXXXXXXXXXXXXXXXXXXXXXXXXXXXXX
XXXXXXXXXXXXXXXXXXXXXXXXXXXXXXXXXXXXXXXXXXXXXXXXXXXXXXXXXXXXXXXXXXXXXXXXXXXXXXXXXXXXXXXXXXXXXXXXXXXXX
XXXXXXXXXXXXXXXXXXXXXXXXXXXXXXXXXXXXXXXXXXXXXXXXXXXXXXXXXXXXXXXXXXXXXXXXXXXXXXXXXXXXXXXXXXXXXXXXXXXXX
XXXXXXXXXXXXXXXXXXXXXXXXXXXXXXXXXXXXXXXXXXXXXXXXXXXXXXXXXXXXXXXXXXXXXXXXXXXXXXXXXXXXXXXXXXXXXXXXXXXXX
XXXXXXXXXXXXXXXXXXXXXXXXXXXXXXXXXXXXXXXXXXXXXXXXXXXXXXXXXXXXXXXXXXXXXXXXXXXXXXXXXXXXXXXXXXXXXXXXXXXXX
XXXXXXXXXXXXXXXXXXXXXXXXXXXXXXXXXXXXXXXXXXXXXXXXXXXXXXXXXXXXXXXXXXXXXXXXXXXXXXXXXXXXXXXXXXXXXXXXXXXXX
XXXXXXXXXXXXXXXXXXXXXXXXXXXXXXXXXXXXXXXXXXXXXXXXXXXXXXXXXXXXXXXXXXXXXXXXXXXXXXXXXXXXXXXXXXXXXXXXXXXXX
XXXXXXXXXXXXXXXXXXXXXXXXXXXXXXXXXXXXXXXXXXXXXXXXXXXXXXXXXXXXXXXXXXXXXXXXXXXXXXXXXXXXXXXXXXXXXXXXXXXXX
XXXXXXXXXXXXXXXXXXXXXXXXXXXXXXXXXXXXXXXXXXXXXXXXXXXXXXXXXXXXXXXXXXXXXXXXXXXXXXXXXXXXXXXXXXXXXXXXXXXXX
XXXXXXXXXXXXXXXXXXXXXXXXXXXXXXXXXXXXXXXXXXXXXXXXXXXXXXXXXXXXXXXXXXXXXXXXXXXXXXXXXXXXXXXXXXXXXXXXXXXXX
XXXXXXXXXXXXXXXXXXXXXXXXXXXXXXXXXXXXXXXXXXXXXXXXXXXXXXXXXXXXXXXXXXXXXXXXXXXXXXXXXXXXXXXXXXXXXXXXXXXXX
XXXXXXXXXXXXXXXXXXXXXXXXXXXXXXXXXXXXXXXXXXXXXXXXXXXXXXXXXXXXXXXXXXXXXXXXXXXXXXXXXXXXXXXXXXXXXXXXXXXXX
XXXXXXXXXXXXXXXXXXXXXXXXXXXXXXXXXXXXXXXXXXXXXXXXXXXXXXXXXXXXXXXXXXXXXXXXXXXXXXXXXXXXXXXXXXXXXXXXXXXXX
XXXXXXXXXXXXXXXXXXXXXXXXXXXXXXXXXXXXXXXXXXXXXXXXXXXXXXXXXXXXXXXXXXXXXXXXXXXXXXXXXXXXXXXXXXXXXXXXXXXXX
XXXXXXXXXXXXXXXXXXXXXXXXXXXXXXXXXXXXXXXXXXXXXXXXXXXXXXXXXXXXXXXXXXXXXXXXXXXXXXXXXXXXXXXXXXXXXXXXXXXXX
XXXXXXXXXXXXXXXXXXXXXXXXXXXXXXXXXXXXXXXXXXXXXXXXXXXXXXXXXXXXXXXXXXXXXXXXXXXXXXXXXXXXXXXXXXXXXXXXXXXXX
XXXXXXXXXXXXXXXXXXXXXXXXXXXXXXXXXXXXXXXXXXXXXXXXXXXXXXXXXXXXXXXXXXXXXXXXXXXXXXXXXXXXXXXXXXXXXXXXXXXXX
XXXXXXXXXXXXXXXXXXXXXXXXXXXXXXXXXXXXXXXXXXXXXXXXXXXXXXXXXXXXXXXXXXXXXXXXXXXXXXXXXXXXXXXXXXXXXXXXXXXXX
XXXXXXXXXXXXXXXXXXXXXXXXXXXXXXXXXXXXXXXXXXXXXXXXXXXXXXXXXXXXXXXXXXXXXXXXXXXXXXXXXXXXXXXXXXXXXXXXXXXXX
XXXXXXXXXXXXXXXXXXXXXXXXXXXXXXXXXXXXXXXXXXXXXXXXXXXXXXXXXXXXXXXXXXXXXXXXXXXXXXXXXXXXXXXXXXXXXXXXXXXXX
